,reflect,hint,select,raw_reflect_hint,raw_select,reflect_prompt_tokens,reflect_completion_tokens,reflect_total_tokens,select_prompt_tokens,select_completion_tokens,select_total_tokens
0,"The initial solution incorrectly multiplied the number of days per week by the number of weeks per semester, resulting in an overestimation of the total number of hours. Additionally, the solution did not consider the number of classes per day on Tuesdays and Thursdays.","When calculating the total number of hours, make sure to consider the number of classes per day and the duration of each class on each day of the week.",cot,"Reflection: The initial solution incorrectly multiplied the number of days per week by the number of weeks per semester, resulting in an overestimation of the total number of hours. Additionally, the solution did not consider the number of classes per day on Tuesdays and Thursdays.

Hint: When calculating the total number of hours, make sure to consider the number of classes per day and the duration of each class on each day of the week.",Promising Method: cot,4127,87,4214,3854,5,3859
1,"The initial solution fails to correctly calculate the cost of lemons. It subtracts the cost of sugar from the total cost, which is incorrect.","When calculating the cost of lemons, make sure to only consider the cost of lemons and not subtract the cost of sugar.",p2c,"Reflection: The initial solution fails to correctly calculate the cost of lemons. It subtracts the cost of sugar from the total cost, which is incorrect.

Hint: When calculating the cost of lemons, make sure to only consider the cost of lemons and not subtract the cost of sugar.",Promising Method: p2c,4120,59,4179,3841,7,3848
2,The initial solution fails to consider that each subsequent runner in the less well-rounded team will be 3 seconds faster than the previous runner. It only calculates the time difference between the first runners of both teams.,"To calculate the total time difference, consider the time difference for each runner in the less well-rounded team and sum them up.",p2c,"Reflection: The initial solution fails to consider that each subsequent runner in the less well-rounded team will be 3 seconds faster than the previous runner. It only calculates the time difference between the first runners of both teams.
Hint: To calculate the total time difference, consider the time difference for each runner in the less well-rounded team and sum them up.",The most promising method for answering this question would be the `p2c` (Plan-to-Code) method. This is because the question requires calculating the total time difference by considering the time difference for each runner in the less well-rounded team and summing them up. Writing a plan and then writing the code based on the plan would be an effective approach to solve this problem.,4153,70,4223,3902,77,3979
3,"The initial solution incorrectly calculated the number of candies James has by subtracting 6 from the number of candies Robert has, instead of adding 6. This led to an incorrect calculation of the difference in candies between John and James.","When calculating the number of candies James has, remember that he has 6 more candies than Robert. Also, pay attention to the relationship between John's and Robert's number of candies to accurately calculate the difference.",cot,"Reflection: The initial solution incorrectly calculated the number of candies James has by subtracting 6 from the number of candies Robert has, instead of adding 6. This led to an incorrect calculation of the difference in candies between John and James.

Hint: When calculating the number of candies James has, remember that he has 6 more candies than Robert. Also, pay attention to the relationship between John's and Robert's number of candies to accurately calculate the difference.",Promising Method: cot,3993,92,4085,3830,5,3835
4,The initial solution fails to accurately calculate the change by subtracting the total cost from the amount paid. This could be due to rounding errors in floating-point arithmetic.,"When dealing with monetary values, it is important to be aware of potential rounding errors in floating-point arithmetic. To avoid such errors, it is recommended to use decimal or integer arithmetic for precise calculations involving money.",p2c,"Reflection: The initial solution fails to accurately calculate the change by subtracting the total cost from the amount paid. This could be due to rounding errors in floating-point arithmetic.

Hint: When dealing with monetary values, it is important to be aware of potential rounding errors in floating-point arithmetic. To avoid such errors, it is recommended to use decimal or integer arithmetic for precise calculations involving money.",Promising Method: p2c,4021,77,4098,3839,7,3846
5,The initial solution fails to consider that each sheet of paper can contain 4 pages when folded. It incorrectly assumes that each sheet can only contain 2 pages.,"When folding a piece of paper vertically and unfolding, each sheet can contain 4 pages (2 on the front and 2 on the back).",p2c,"Reflection: The initial solution fails to consider that each sheet of paper can contain 4 pages when folded. It incorrectly assumes that each sheet can only contain 2 pages.

Hint: When folding a piece of paper vertically and unfolding, each sheet can contain 4 pages (2 on the front and 2 on the back).",p2c,4068,65,4133,3867,3,3870
6,"The initial solution incorrectly calculated the total number of electric poles by dividing the number of electric wires by the ratio of poles to wires. However, the ratio given is 1:3, which means for every 1 electric pole, there are 3 electric wires. Therefore, to find the total number of electric poles, we need to divide the number of electric wires by 3, not the ratio.","When dealing with ratios, it's important to understand the relationship between the two quantities and how they are related. In this case, the ratio of 1:3 means that for every 1 electric pole, there are 3 electric wires.",p2c,"Reflection: The initial solution incorrectly calculated the total number of electric poles by dividing the number of electric wires by the ratio of poles to wires. However, the ratio given is 1:3, which means for every 1 electric pole, there are 3 electric wires. Therefore, to find the total number of electric poles, we need to divide the number of electric wires by 3, not the ratio.

Hint: When dealing with ratios, it's important to understand the relationship between the two quantities and how they are related. In this case, the ratio of 1:3 means that for every 1 electric pole, there are 3 electric wires.",p2c,4038,134,4172,3867,3,3870
7,"The initial solution incorrectly calculates the number of students in the smallest group by subtracting 10 from the number of students in the equal groups, instead of subtracting 10 from each of the equal groups.","When calculating the number of students in the smallest group, make sure to subtract 10 from each of the equal groups, not just once.",cot,"Reflection: The initial solution incorrectly calculates the number of students in the smallest group by subtracting 10 from the number of students in the equal groups, instead of subtracting 10 from each of the equal groups.
Hint: When calculating the number of students in the smallest group, make sure to subtract 10 from each of the equal groups, not just once.",Promising Method: cot,4009,73,4082,3836,5,3841
8,"The initial solution incorrectly calculated the total distance per day by multiplying the total distance per trip by the number of trips per day. However, it failed to consider that the distance from the third city to the first city is 50 miles less than the combined distance of the other two legs of the trip. This resulted in an incorrect calculation of the total distance per day and, consequently, the number of days between services.","When calculating the total distance per day, make sure to accurately consider the distance from the third city to the first city, which is 50 miles less than the combined distance of the other two legs of the trip.",cot,"Reflection: The initial solution incorrectly calculated the total distance per day by multiplying the total distance per trip by the number of trips per day. However, it failed to consider that the distance from the third city to the first city is 50 miles less than the combined distance of the other two legs of the trip. This resulted in an incorrect calculation of the total distance per day and, consequently, the number of days between services.

Hint: When calculating the total distance per day, make sure to accurately consider the distance from the third city to the first city, which is 50 miles less than the combined distance of the other two legs of the trip.","The most promising method for answering the given question would be `cot` (Chain-of-Thought). This is because the question requires step-by-step verbal reasoning to accurately calculate the total distance per day, taking into account the specific distance from the third city to the first city. The hint also emphasizes the need for accurate consideration of this distance. Therefore, using the `cot` method would be the most suitable approach to solve this problem.",4134,130,4264,3884,87,3971
9,"The initial solution incorrectly calculated the number of apples Joanne gathered from the average trees by subtracting the apples gathered by both Joanne and her sister from the total number of apples and dividing by 2. This approach assumes that the sister gathered the same number of apples from the average trees as Joanne, which is not stated in the question.","To find the number of apples Joanne gathered from the average trees, subtract the apples gathered from the tallest and shortest trees by both Joanne and her sister from the total number of apples.",cot,"Reflection: The initial solution incorrectly calculated the number of apples Joanne gathered from the average trees by subtracting the apples gathered by both Joanne and her sister from the total number of apples and dividing by 2. This approach assumes that the sister gathered the same number of apples from the average trees as Joanne, which is not stated in the question.

Hint: To find the number of apples Joanne gathered from the average trees, subtract the apples gathered from the tallest and shortest trees by both Joanne and her sister from the total number of apples.",The most promising method for answering the given question would be the Chain-of-Thought (`cot`) reasoning method. This is because the question requires step-by-step verbal reasoning to calculate the number of apples Joanne gathered from the average trees. The hint also suggests using verbal reasoning to subtract the apples gathered from the tallest and shortest trees by both Joanne and her sister from the total number of apples.,4210,111,4321,3902,79,3981
10,"The initial solution fails to accurately calculate the regular price of popcorn. It subtracts the savings from the difference between the prices of the super ticket and the regular ticket, instead of considering the additional cost of the popcorn. This leads to a negative value for the regular popcorn price, which is incorrect.","When calculating the regular price of popcorn, consider the additional cost of the popcorn when buying the regular ticket. Also, double-check the calculation to ensure that the result makes sense in the context of the problem.",p2c,"Reflection: The initial solution fails to accurately calculate the regular price of popcorn. It subtracts the savings from the difference between the prices of the super ticket and the regular ticket, instead of considering the additional cost of the popcorn. This leads to a negative value for the regular popcorn price, which is incorrect.

Hint: When calculating the regular price of popcorn, consider the additional cost of the popcorn when buying the regular ticket. Also, double-check the calculation to ensure that the result makes sense in the context of the problem.",p2c,4111,104,4215,3874,3,3877
11,"The initial solution incorrectly calculated the cost per razor by dividing the total cost by the total number of razors. However, the discount should be applied to the total cost before calculating the cost per razor.","When calculating the cost per razor after a discount, make sure to subtract the discount from the total cost before dividing by the total number of razors.",p2c,"Reflection: The initial solution incorrectly calculated the cost per razor by dividing the total cost by the total number of razors. However, the discount should be applied to the total cost before calculating the cost per razor.

Hint: When calculating the cost per razor after a discount, make sure to subtract the discount from the total cost before dividing by the total number of razors.",The most promising method for answering the given question would be `p2c` (Plan-to-Code).,4093,74,4167,3851,22,3873
12,The initial solution fails to account for the fact that Josh spent 4 hours working out every week except on some occasions. It incorrectly assumes that he spent 4 hours every week.,"When solving this type of question, it is important to carefully consider the given information and accurately calculate the total number of hours based on that information.",cot,"Reflection: The initial solution fails to account for the fact that Josh spent 4 hours working out every week except on some occasions. It incorrectly assumes that he spent 4 hours every week. 

Hint: When solving this type of question, it is important to carefully consider the given information and accurately calculate the total number of hours based on that information.",Promising Method: cot,4074,70,4144,3855,5,3860
13,"The initial solution incorrectly calculates the number of candies Nick has by multiplying the number of candies George ate by 2, instead of multiplying it by 2 and adding it to the number of candies George has left. This results in the incorrect answer of 0 candies for Nick.","When calculating the number of candies Nick has, make sure to consider both the initial number of candies Nick had and the number of candies George ate.",cot,"Reflection: The initial solution incorrectly calculates the number of candies Nick has by multiplying the number of candies George ate by 2, instead of multiplying it by 2 and adding it to the number of candies George has left. This results in the incorrect answer of 0 candies for Nick.

Hint: When calculating the number of candies Nick has, make sure to consider both the initial number of candies Nick had and the number of candies George ate.",Promising Method: cot,3990,88,4078,3813,5,3818
14,"The initial solution incorrectly calculated the number of toys Jonathan currently has by adding 2 to the number of toys needed to make a play set five times larger than James's. However, the question asks for the number of toys Jonathan currently has, not the number of toys needed.","To find the number of toys Jonathan currently has, subtract 2 from the number of toys needed to make a play set five times larger than James's.",cot,"Reflection: The initial solution incorrectly calculated the number of toys Jonathan currently has by adding 2 to the number of toys needed to make a play set five times larger than James's. However, the question asks for the number of toys Jonathan currently has, not the number of toys needed.

Hint: To find the number of toys Jonathan currently has, subtract 2 from the number of toys needed to make a play set five times larger than James's.",Promising Method: cot,3996,90,4086,3832,5,3837
15,The initial solution fails to accurately calculate the maximum number of classes Manny can miss before his parents don't sign him up again. It incorrectly calculates the maximum classes missed by subtracting the product of the maximum cost per class and the total number of classes from the total cost and then dividing by the maximum cost per class. This leads to a negative result.,"To calculate the maximum number of classes Manny can miss, divide the total cost by the maximum cost per class and subtract it from the total number of classes.",cot,"Reflection: The initial solution fails to accurately calculate the maximum number of classes Manny can miss before his parents don't sign him up again. It incorrectly calculates the maximum classes missed by subtracting the product of the maximum cost per class and the total number of classes from the total cost and then dividing by the maximum cost per class. This leads to a negative result.

Hint: To calculate the maximum number of classes Manny can miss, divide the total cost by the maximum cost per class and subtract it from the total number of classes.",Promising Method: cot,4043,105,4148,3844,5,3849
16,"The initial solution fails to accurately calculate the number of days it will take for Mike to finish reading the book. It divides the total number of pages by the number of pages Mike plans to read per day, but it does not consider the time constraint of 30 days.","When solving problems with time constraints, make sure to consider the given time frame and adjust the calculations accordingly.",cot,"Reflection: The initial solution fails to accurately calculate the number of days it will take for Mike to finish reading the book. It divides the total number of pages by the number of pages Mike plans to read per day, but it does not consider the time constraint of 30 days.
Hint: When solving problems with time constraints, make sure to consider the given time frame and adjust the calculations accordingly.",Promising Method: cot,3998,79,4077,3823,5,3828
17,The initial solution incorrectly calculates the percentage of water used for non-industrial purposes by subtracting the percentage of water used for industrial purposes from the percentage of water used by the city. This approach does not accurately represent the relationship between the two percentages.,"When calculating the percentage of water used for non-industrial purposes, it is important to consider the relationship between the percentages of water used by the city and for industrial purposes. One possible approach is to calculate the percentage of water used for industrial purposes first and then subtract it from 100% to find the percentage of water used for non-industrial purposes.",p2c,"Reflection: The initial solution incorrectly calculates the percentage of water used for non-industrial purposes by subtracting the percentage of water used for industrial purposes from the percentage of water used by the city. This approach does not accurately represent the relationship between the two percentages.

Hint: When calculating the percentage of water used for non-industrial purposes, it is important to consider the relationship between the percentages of water used by the city and for industrial purposes. One possible approach is to calculate the percentage of water used for industrial purposes first and then subtract it from 100% to find the percentage of water used for non-industrial purposes.",p2c,4057,123,4180,3869,3,3872
18,The initial solution fails to accurately calculate the weekly savings by subtracting the new vendor price from the old vendor price and multiplying it by the number of tomatoes sold per day. It also fails to consider the number of days in a week when calculating the weekly savings.,"When calculating the weekly savings, make sure to multiply the daily savings by the number of days in a week (7) to get the accurate result. Additionally, pay attention to the precision of the result when dealing with decimal numbers.",p2c,"Reflection: The initial solution fails to accurately calculate the weekly savings by subtracting the new vendor price from the old vendor price and multiplying it by the number of tomatoes sold per day. It also fails to consider the number of days in a week when calculating the weekly savings.

Hint: When calculating the weekly savings, make sure to multiply the daily savings by the number of days in a week (7) to get the accurate result. Additionally, pay attention to the precision of the result when dealing with decimal numbers.",p2c,4047,102,4149,3855,3,3858
19,The initial solution incorrectly calculated the number of cases of shingles needed for the second house by dividing the total cases by the sum of the ratios. This resulted in an incorrect calculation for the number of cases needed for the third house.,"When calculating the number of cases of shingles needed for each house, it is important to accurately consider the ratios given in the question.",cot,"Reflection: The initial solution incorrectly calculated the number of cases of shingles needed for the second house by dividing the total cases by the sum of the ratios. This resulted in an incorrect calculation for the number of cases needed for the third house.

Hint: When calculating the number of cases of shingles needed for each house, it is important to accurately consider the ratios given in the question.",Promising Method: cot,4041,77,4118,3846,5,3851
20,"The initial solution incorrectly calculated the amount of oil by dividing the jar capacity by the sum of all the ingredients, instead of considering the ratios between the ingredients.","When solving problems with ratios between ingredients, it is important to accurately calculate the amounts based on the given ratios.",cot,"Reflection: The initial solution incorrectly calculated the amount of oil by dividing the jar capacity by the sum of all the ingredients, instead of considering the ratios between the ingredients.
Hint: When solving problems with ratios between ingredients, it is important to accurately calculate the amounts based on the given ratios.",Promising Method: cot,4078,57,4135,3852,5,3857
21,"The initial solution incorrectly calculated the time it would take for the four turtles to travel across the highway by dividing the total time taken by the kangaroos by the ratio of the total kangaroo speed to the total turtle speed. However, this calculation does not account for the fact that the turtles are traveling at half the speed of the kangaroos.","When calculating the time it takes for the turtles to travel across the highway, consider the ratio of the turtle speed to the kangaroo speed and adjust the calculation accordingly.",cot,"Reflection: The initial solution incorrectly calculated the time it would take for the four turtles to travel across the highway by dividing the total time taken by the kangaroos by the ratio of the total kangaroo speed to the total turtle speed. However, this calculation does not account for the fact that the turtles are traveling at half the speed of the kangaroos.

Hint: When calculating the time it takes for the turtles to travel across the highway, consider the ratio of the turtle speed to the kangaroo speed and adjust the calculation accordingly.",Promising Method: cot,4054,107,4161,3835,5,3840
22,"The initial solution fails to correctly calculate the number of yellow cars because it tries to calculate the total number of cars before assigning a value to the variable ""yellow_cars"". This leads to an error in the calculation of ""total_cars"" and consequently the calculation of ""yellow_cars"".","When solving a problem that involves multiple variables and their relationships, it is important to assign values to all variables before performing any calculations that depend on them.",p2c,"Reflection: The initial solution fails to correctly calculate the number of yellow cars because it tries to calculate the total number of cars before assigning a value to the variable ""yellow_cars"". This leads to an error in the calculation of ""total_cars"" and consequently the calculation of ""yellow_cars"".

Hint: When solving a problem that involves multiple variables and their relationships, it is important to assign values to all variables before performing any calculations that depend on them.",p2c,4068,92,4160,3850,3,3853
23,"The initial solution incorrectly calculates the money spent by subtracting the cost of the discounted CDs and the money earned from selling the unwanted CDs from the total cost of the CDs. However, this approach does not accurately reflect the amount of money James is out, as it does not take into account the discount he received on the CDs.","To accurately calculate the amount of money James is out, it is important to consider the discount he received on the CDs. One approach could be to calculate the total cost of the CDs without the discount, subtract the money earned from selling the unwanted CDs, and then subtract the total cost of the CDs with the discount.",p2c,"Reflection: The initial solution incorrectly calculates the money spent by subtracting the cost of the discounted CDs and the money earned from selling the unwanted CDs from the total cost of the CDs. However, this approach does not accurately reflect the amount of money James is out, as it does not take into account the discount he received on the CDs.

Hint: To accurately calculate the amount of money James is out, it is important to consider the discount he received on the CDs. One approach could be to calculate the total cost of the CDs without the discount, subtract the money earned from selling the unwanted CDs, and then subtract the total cost of the CDs with the discount.",p2c,4049,132,4181,3865,3,3868
24,"The agent made a mistake in calculating the sleep duration by subtracting the start time from the end time without considering the fact that the sleep duration spans across two different days. Additionally, the agent did not account for the fact that Kim woke up 5 minutes earlier than usual to go to the bathroom.","When calculating the sleep duration, consider the possibility of the sleep duration spanning across two different days. Also, remember to account for any additional time spent awake, such as the time spent in the bathroom.",cot,"Reflection: The agent made a mistake in calculating the sleep duration by subtracting the start time from the end time without considering the fact that the sleep duration spans across two different days. Additionally, the agent did not account for the fact that Kim woke up 5 minutes earlier than usual to go to the bathroom.

Hint: When calculating the sleep duration, consider the possibility of the sleep duration spanning across two different days. Also, remember to account for any additional time spent awake, such as the time spent in the bathroom.","The most promising method for answering this question would be the Chain-of-Thought (`cot`) reasoning method. This is because the question requires step-by-step verbal reasoning to calculate the sleep duration, taking into account the possibility of the sleep duration spanning across two different days and the additional time spent awake in the bathroom.",4234,104,4338,3902,62,3964
25,"The initial solution incorrectly calculated the number of checks per year by multiplying the number of checks per month by the number of months per year. However, this approach does not account for the fact that Buford writes checks to the church twice per month and to the pest and lawn service quarterly.","To accurately calculate the number of checks Buford writes per year, consider the frequency of each type of check and adjust the calculation accordingly.",cot,"Reflection: The initial solution incorrectly calculated the number of checks per year by multiplying the number of checks per month by the number of months per year. However, this approach does not account for the fact that Buford writes checks to the church twice per month and to the pest and lawn service quarterly.

Hint: To accurately calculate the number of checks Buford writes per year, consider the frequency of each type of check and adjust the calculation accordingly.",Promising Method: cot,4066,88,4154,3853,5,3858
26,The initial solution incorrectly calculated the initial charge of the power bank when Maria went out to the park. It did not take into account the fact that the power bank was not fully charged before Maria disconnected it.,"When solving this type of question, it is important to consider the initial conditions accurately. In this case, the initial charge of the power bank should be calculated based on the charge remaining after the first period of charging.",cot,"Reflection: The initial solution incorrectly calculated the initial charge of the power bank when Maria went out to the park. It did not take into account the fact that the power bank was not fully charged before Maria disconnected it. 

Hint: When solving this type of question, it is important to consider the initial conditions accurately. In this case, the initial charge of the power bank should be calculated based on the charge remaining after the first period of charging.",The most promising method for answering the given question would be the Chain-of-Thought (`cot`) reasoning method. This is because the question requires step-by-step verbal reasoning to accurately consider the initial conditions and calculate the charge of the power bank when Maria went out to the park.,4228,89,4317,3915,55,3970
27,"The initial solution incorrectly calculates the fabric area by adding 2 to both the length and width of the bed. However, the question states that Jim needs two pieces of fabric that are 2 feet longer and 2 feet wider than the bed, so the correct calculation should be to add 4 to both the length and width of the bed.",Pay close attention to the specific requirements stated in the question and make sure to accurately incorporate them into the calculations.,cot,"Reflection: The initial solution incorrectly calculates the fabric area by adding 2 to both the length and width of the bed. However, the question states that Jim needs two pieces of fabric that are 2 feet longer and 2 feet wider than the bed, so the correct calculation should be to add 4 to both the length and width of the bed.

Hint: Pay close attention to the specific requirements stated in the question and make sure to accurately incorporate them into the calculations.",Promising Method: cot,4030,95,4125,3832,5,3837
28,The initial solution incorrectly calculated the population of girls by using the percentage of boys instead of the percentage of girls. This resulted in an incorrect answer.,"When calculating the population of one group based on a percentage, make sure to subtract that percentage from 100 to get the percentage of the other group.",cot,"Reflection: The initial solution incorrectly calculated the population of girls by using the percentage of boys instead of the percentage of girls. This resulted in an incorrect answer.

Hint: When calculating the population of one group based on a percentage, make sure to subtract that percentage from 100 to get the percentage of the other group.",Promising Method: cot,3957,63,4020,3806,5,3811
29,"The initial solution fails to correctly calculate the total number of marbles Bob will have after receiving 2 dozen more marbles. It incorrectly assumes that the initial number of marbles is 0, which is not stated in the question.","When solving word problems, carefully read and understand the given information and make sure to accurately calculate the values based on the information provided.",cot,"Reflection: The initial solution fails to correctly calculate the total number of marbles Bob will have after receiving 2 dozen more marbles. It incorrectly assumes that the initial number of marbles is 0, which is not stated in the question.

Hint: When solving word problems, carefully read and understand the given information and make sure to accurately calculate the values based on the information provided.",Promising Method: cot,4027,77,4104,3826,5,3831
30,"The initial solution fails to consider that Lauren can only draw a whole number of scenes per day, not fractions. Therefore, the solution should round up the number of days needed for each type of scene to ensure that all scenes are completed.","When dealing with quantities that cannot be divided evenly, consider rounding up to the nearest whole number to ensure that all items are accounted for.",p2c,"Reflection: The initial solution fails to consider that Lauren can only draw a whole number of scenes per day, not fractions. Therefore, the solution should round up the number of days needed for each type of scene to ensure that all scenes are completed.

Hint: When dealing with quantities that cannot be divided evenly, consider rounding up to the nearest whole number to ensure that all items are accounted for.",p2c,4174,78,4252,3874,3,3877
31,The initial solution fails to accurately calculate the number of cupcakes Carly made because it incorrectly calculates the number of brownies first and then subtracts it from the total treats to get the number of cupcakes. This approach does not consider the fact that Carly makes 2 less than three times as many brownies as cupcakes.,"To accurately calculate the number of cupcakes Carly made, start by defining a variable to represent the number of cupcakes. Then, use the given information that Carly makes 2 less than three times as many brownies as cupcakes to calculate the number of brownies. Finally, subtract the number of brownies from the total treats to get the number of cupcakes.",p2c,"Reflection: The initial solution fails to accurately calculate the number of cupcakes Carly made because it incorrectly calculates the number of brownies first and then subtracts it from the total treats to get the number of cupcakes. This approach does not consider the fact that Carly makes 2 less than three times as many brownies as cupcakes.

Hint: To accurately calculate the number of cupcakes Carly made, start by defining a variable to represent the number of cupcakes. Then, use the given information that Carly makes 2 less than three times as many brownies as cupcakes to calculate the number of brownies. Finally, subtract the number of brownies from the total treats to get the number of cupcakes.",p2c,4028,136,4164,3871,3,3874
32,"The initial solution incorrectly subtracted the number of oatmeal cookies eaten for lunch instead of adding them. This resulted in an incorrect calculation of the number of oatmeal cookies left. Additionally, the solution did not correctly account for the number of chocolate chip cookies left after baking.","When calculating the number of cookies left, make sure to accurately add or subtract the correct quantities based on the given information. Double-check the calculations for each type of cookie to ensure accuracy.",cot,"Reflection: The initial solution incorrectly subtracted the number of oatmeal cookies eaten for lunch instead of adding them. This resulted in an incorrect calculation of the number of oatmeal cookies left. Additionally, the solution did not correctly account for the number of chocolate chip cookies left after baking.

Hint: When calculating the number of cookies left, make sure to accurately add or subtract the correct quantities based on the given information. Double-check the calculations for each type of cookie to ensure accuracy.",Promising Method: cot,4222,95,4317,3867,5,3872
33,"The initial solution incorrectly calculates James' age by assuming he is currently twice as old as Dora will be in 3 years, instead of considering their current ages. Additionally, the solution fails to calculate the age of John's youngest son correctly by simply adding 3 to John's age when the youngest son was born.","When solving age-related problems, it is important to consider the current ages of the individuals involved and accurately calculate their ages based on the given information.",cot,"Reflection: The initial solution incorrectly calculates James' age by assuming he is currently twice as old as Dora will be in 3 years, instead of considering their current ages. Additionally, the solution fails to calculate the age of John's youngest son correctly by simply adding 3 to John's age when the youngest son was born.
Hint: When solving age-related problems, it is important to consider the current ages of the individuals involved and accurately calculate their ages based on the given information.","The most promising method for answering the given question would be the Chain-of-Thought (`cot`) reasoning method. This is because the question involves multiple individuals with different ages and their relationships, and it requires step-by-step verbal reasoning to accurately calculate their ages based on the given information.",4065,97,4162,3840,56,3896
